13 10
100 100
4 5 5 5 5 5 5 5 5 5 5 5 6
10 0 0 0 0 0 0 0 0 0 0 0 11
10 1 1 1 1 1 1 1 1 1 1 1 11
10 2 2 2 2 2 2 2 2 2 2 2 11
10 3 3 3 3 3 3 3 3 3 3 3 11
10 0 0 0 0 0 0 0 0 0 0 0 11
10 1 1 1 1 1 1 1 1 1 1 1 11
10 2 2 2 2 2 2 2 2 2 2 2 11
10 3 3 3 3 3 3 3 3 3 3 3 11
7 8 8 8 8 8 8 8 8 8 8 8 9