x x x x x x x x x x x x x x x
x x x x b b x b b x b x b b x
x x u b u u b b b u u b u b x
x x b x b b b x b b b b b x x
x b u b b b b u b x b x u x x
x x u x b x b u b b b b u b x
x x b b b b b x b b b x b x x
x b u b u u b b b u u b u x x
x b b x b x b b x b b x x x x
x x x x x x x x x x x x x x x